Trump Just Insulted Millions Who Lost Everything In Bush's Recession, "That's Just Business"	true
Famous dog killed in spot she waited a year for her owner to return to! [VIDEO]	true
House oversight panel votes Clinton IT chief in contempt	true
America Just Tragically Lost A Country Music Icon, Please Pray For Jean Shepard’s Family	true
Monuments to the Battle for the New South	true
RACE TIED on debate day; Colo. and Pa. have turned tight -- CLINTON hosting more than 1,200 watch parties -- THE PLAYBOOK INTERVIEW: Stephanie Schriock -- B’DAY: Dave Weigel	true
Giuliani slams Lester Holt for fact-checking like Candy Crowley	true
Kaine doesn't feel bad for Pence	true
Anti-Trump Super PAC Launches Pre-Debate Video Featuring Hofstra Students	true
Glenn Beck shares buyer's remorse on Cruz endorsement	true
NY Gov. Andrew Cuomo disputes Trump's claim cops are 'afraid' to do their jobs	true
Clinton economy speech to focus on valuing people with disabilities	true
Trump: 'I was going to say something extremely rough' to Clinton	true
The 8 Biggest Unforced Errors in Debate History	true
Trump Calls For This Racist Policy To Be Forced On Every State	true
Obama Claims It Will Be A Personal Insult If You Don’t Vote For Hillary [VIDEO]	true
Robert Kennedy Would Have Hated Donald Trump	true
Is West Virginia Holding America’s Weirdest Election?	true
This Was the Trump Hillary Wanted America to See—But Did It Work?	true
Pence: There's too much talk of police department 'racism'	true
Trump Jr. Once Again Shows His Lack Of Humanity With Disgusting Tweet About Syrian Refugees	true
Clinton demands Charlotte police video release 'without delay'	true
Muslim Afghani Rapes 2-YEAR-OLD, Gets 2 Years in Prison…Declares Himself ‘Superstar’ – Eagle Rising	true
Trump needles Clinton: ‘Sleep well Hillary — see you at the debate!’	true
TRUTH COMES OUT! Keith Lamont Scott's Did This To His Wife Last Year and She Said "He is a Killer" ⋆ Freedom Daily	true
Trump Won’t Tell America Where His Products Are Made, So Here’s A Handy Guide (IMAGES)	true
Black Caucus marches to DOJ to protest shootings	true
Trump Silent As Police Credit A Sikh Immigrant With Capturing NYC Bomber	true
Clinton on Trump's birther claim: A 'racist lie'	true
When does early voting start in every state?	true
Rep. Peter King: We shouldn't be 'pandering' to political correctness	true
28-year-old man sought in Manhattan blast	true
Trump Campaign Chair Says Racism Didn't Exist Before Obama In Viral Rant	true
Christie among the most unpopular governors in the country, poll finds	true
Donald Trump, Hillary Clinton Spar Over Taxes in First Presidential Debate	true
Look What Was Just SPOTTED Inside The Student Center At Hofstra University	true
Early Voting In North Carolina Shows GREAT NEWS For Democrats	true
Cop Dies From Tuberculosis After Suspect Spat At Her	true
UK Begins Construction On “Great Wall” – Meant to Keep Illegal Migrants OUT (VIDEO)	true
Donald Trump, Germany’s disfavored son – POLITICO	true
NFL Superstar Unleashes 4 Word Bombshell on Reporter Pushing Him to Protest Anthem	true
Trump team talking to veteran GOP ad man Elsass	true
McCrory calls state of emergency in Charlotte after unrest	true
'Locked the black bitch out': White students under investigation after racist Snapchat reveals campus harassment	true
Donald Trump Calls for Nationwide Stop-and-Frisk Policy, Then Rolls It Back	true
UN to resume Syria aid deliveries – POLITICO	true
KISS’ Gene Simmons: “You Want to Win the War on Terror? Profile Everyone, Profile ME!” [VIDEO]	true
Kerry says Syrian diplomacy at impasse after truce collapses	true
Ford Motor CEO Says Trump Is Lying AGAIN! Company Is NOT Moving U.S. Operations To Mexico	true
BREAKING: Toby Keith Forced To Cancel Show, I Didn’t Expect This	true
Clinton, Trump meet world leaders for very different reasons	true
Road to 270: CNN's general election map	true
North Korea at UN: US faces 'tremendous consequences'	true
“See What Happens to Her!” [VIDEO] – Eagle Rising	true
Massive Protests Erupt In North Carolina After Police Kill Disabled Black Man	true
LA Police Commission Tells Officers How To Deal With Armed Suspects And It Is INSANE ⋆ Freedom Daily	true
ABC News – Breaking News, Latest News, Headlines & Videos	true
Worst. President. Ever.	true
Texas, California Separatists Attend Kremlin-Funded Conference	true
Obama, in an awkward twist, becomes Saudi Arabia's defender	true
McConnell punts budget vote to buy time for deal	true
Former Miss Universe sizes up Melania Trump: 'I think I speak more English'	true
Ivanka Trump to meet with female Republican Congress members	true
Barney Frank: Tea party outmaneuvered Democrats	true
BREAKING: North Carolina Drops Anti-LGBT 'Bathroom Bill' Lawsuit Against US	true
Howard Dean ROASTS Trump Over Debate Sniffles: ‘Coke User’? (TWEETS)	true
Obama: 'There's a reason why we haven't had a woman President'	true
Michelle Obama jokes about Melania Trump plagiarism: 'Yeah, that was tough'	true
NFL Superstar Unleashes 4 Word Bombshell on Reporter Pushing Him to Protest Anthem	true
Trump Gets ANNIHILATED On Twitter After He Pretends He Didn’t Just Trash Police Officers (TWEETS)	true
Good News Folks, God Is Now Protecting Donald Trump From A ‘Concentrated Satanic Attack’ (VIDEO)	true
McConnell, Pelosi, Ryan seek deal on government funding impasse	true
Libertarian candidates: We will alter course of the election	true
NFL Superstar Unleashes 4 Word Bombshell on Reporter Pushing Him to Protest Anthem	true
Trump hints Obama to blame for Charlotte unrest	true
US boy, six, asks Obama if he can adopt Omran Daqneesh	true
New York Times Will FINALLY Start Calling Trump A "Liar"	true
Trump 'happy' he didn't bring up Bill Clinton's affairs	true
How Congress Can Override President Obama's Veto of the 9/11 Bill	true
Trump Campaign Chair Says Racism Didn’t Exist Before Obama – Promptly Resigns	true
Obama, Biden honor Arnold Palmer	true
DOJ: Chinese company tried to evade U.S. sanctions against North Korea	true
Debate breaks record as most-watched in U.S. history	true
NATO chief counterattacks against Donald Trump – POLITICO	true
Reality Check: Was 'stop-and-frisk' effective?	true
Trump Jr. defends Skittles tweet: 'I don't deal in microaggression'	true
Obama nominates ambassador to Cuba in long-shot move	true
Conservatives Throw A Hissy Fit Because Michelle Obama Talked About Slavery At Black History Museum	true
Hillary Clinton leads Donald Trump by 6 points, according to national poll	true
Hateful Arizona Pastor Deported From Botswana After Saying Gays Should Be ‘Stoned to Death’ (VIDEO)	true
Twitter Just Wrecked Donald Trump After Horrible Attack On ‘Black Communities’ (TWEETS) ‹ Opposition Report	true
Meet This Week's White Texan Terrorist Trump Isn't Talking About	true
McConnell plays hardball in spending fight	true
What the US government can and cannot do to US citizens suspected of terrorism	true
Trump received $1.6 million from Secret Service	true
ABC News – Breaking News, Latest News, Headlines & Videos	true
Ivanka Trump, Paul Ryan meet	true
Schumer transfers millions to Dems in bid for Senate takeover	true
Trump Said Not Paying Taxes Makes Him "Smart." Mark Cuban's Response Is Powerful	true
Transparent creator Jill Soloway compares 'monster' Trump to Hitler after Emmy win	true
Airstrikes Bury Syrians in Aleppo - ABC News	true
America's relationships are on the line — no matter who wins	true
The Word Liberals are TERRIFIED Of – Eagle Rising	true
Clint Eastwood Had Enough, Blows Up On Hillary And Obama… Liberals	true
Italian prime minister jokes about Bill Clinton as 'first gentleman'	true
WWII Veteran Pens Brutal Op-Ed Slamming Draft-Dodging Trump	true
Louisiana Cop Claims Murdering A 6-Year Old Child Was Self-Defense	true
Paul Ryan defends Donald Trump, dodges on Machado comment	true
Trump launches 'Crooked Hillary' Snapchat filter for debate	true
Trump Said Not Paying Taxes Makes Him "Smart." Mark Cuban's Response Is Powerful	true
Lawyer Jailed For Wearing Black Lives Matter Pin In Court	true
Charity: Clinton Foundation Distributed “Watered-Down” AIDS Drugs to Sub-Saharan Africa – Eagle Rising	true
Trump’s High-Energy War on American Politics	true
Donald Trump is RIGHT on Profiling [VIDEO] – Eagle Rising	true
Hillary Clinton prepares for unpredictable Trump at presidential debate	true
Donald Trump, Germany’s disfavored son – POLITICO	true
BREAKING: Hollywood Legend Just Died Of Terrible Disease	true
Worst. President. Ever.	true
Don King drops N-word while introducing Donald Trump	true
Donald Trump Jr. Compares Syrian Refugees to Skittles	true
Virginia Republican Wants Schools To Check Children's Genitals Before Using Bathroom	false
PUTIN INTERFERENCE COULD GIVE COURTS LEGAL RIGHT TO MAKE HILLARY PRESIDENT	false
Barrels Removed From Clinton Property Contained Parts From 3 Missing Women – Freedum Junkshun	false
Massive Bumble Bee Recall After 2 Employees Admit Cooking A Man And Mixing Him With A Batch Of Tuna	false
JUST IN TODAY Trey Gowdy Is The NEW DIRECTOR Of The FBI	false
BREAKING: Johnny Depp Taken Into Custody By Secret Service	false
State Of Minnesota Has Just Handed Over FULL CONTROL To Muslims So They Can Take Down ‘Infidels’	false
Manager killed 10 employees at checkers on 183st and 27ave	false
Paul Ryan: “Donald Trump Plans To Resign From Office Within The Next 30 Days”	false
Australia Becomes First Country To Begin Microchipping Its Public	false
“Trump Has The Legal Right To Cancel SCOTUS Because They Serve At His Pleasure”	false
The Democrat James Comey Has Been Having An Affair With Was JUST REVEALED! (DETAILS) – Freedum Junkshun	false
War on Christmas Obama orders ban on Christmas cards to military	false
“White People Have Suffered More In The Last 8 Years Than Blacks Did During Couple Years Of Slavery”	false
Paul Ryan: “22 Million Americans Choose To Be Poor, So It’s Their Own Problem If They Can’t Afford To Be Healthy”	false
Obama Goes To G20 Summit	false
CNN Host Fareed Zakaria Calls For Jihad Rape Of White Women – TEO info	false
White House Chef Quits Because Trump Has Only Eaten Fast Food For 6 Months – The Halfway Post	false
Oscar Pistorious commits suicide in Prison – City Herald	false
"The 2nd Amendment Was Written Before Guns Were Invented"	false
A Hollywood Star Is Moving To Canada Because Of President Trump	false
Russian Mansions Obama Seized Were Meant To Be Illegal Gifts To Sasha And Malia – News Feed Hunter	false
Barack Obama Tweets SICK Attack On John McCain, Says He Should Have Died	false
Breaking Crew Of Air Force One Refuses To Fly Obama 6000 Miles ‘Just To Play Golf	false
Wasserman Schultz Going To Mental Hospital After What She Did Overnight Desperate To Escape Arrest	false
ELECTORAL COLLEGE ELECTOR COMMITS SUICIDE TO AVOID VOTING FOR DONALD TRUMP	false
Donald Trump Dead From A Fatal HEART ATTACK!	false
“Koran And Holy Bible Are The Same”	false
Mom applies a remedy to her baby, moments later he dies. Be careful with this, moms!	false
Bill Murray Had This to Say About Rochester, New Hampshire Residents – News Daily 12	false
WE WILL RIOT Michelle Obama’s Mom Will Receive 160k Every Year Out Of Taxpayers’ Pockets	false
Donald Trump warns outgoing Ghana President – USA Radio	false
Denzel Washington Switches to Trump Shocks Hollywood-, Speaks Out Against Obama	false
Confirmed Justice Ruth Bader Ginsburg is RESIGNING From The Post of Associate Justice of the Supreme Court	false
Meryl Streep Just Got Fired From A Major Project For Lying About Trump – Americas Last Line of Defense	false
Mike Pence: “Allowing Rape Victims To Have Abortions Will Lead To Women Trying To Get Raped”	false
Barrack Obama will be on new 1 dollar bill 2017	false
cnnews3.com -&nbspcnnews3 Resources and Information.	false
Executive Order Leads to Capture of ISIS Leader Rasheed Muhammad	false
BREAKING! President Trump Makes ENGLISH The OFFICIAL LANGUAGE OF THE United States!	false
Idaho Mother Sentenced To Prison After Multiple Citations For Breastfeeding In Public	false
New law now charging all violent protesters with terrorism spread the news and share this	false
"I think Donald Trump will go down to history as one of the greatest presidents, just like Reagan."	false
Harambe, A Dead Gorilla, Got Over 15,000 Votes For President Of The Unites States	false
Trump Caught INVESTING in Dakota Pipeline Before Signing It	false
BREAKING Hilary Clinton Filed For Divorce In New York Courts	false
McCain Blamed For Sabotaging Trump	false
Radical Muslims in Australia OFFENDED That Their Children Have to Sing the National Anthem -	false
John Hagee Calls For “Prosecuting Women Who Say God’s Name During Intercourse”	false
Japanese whaling crew eaten alive by killer whales 16 dead	false
Target to discontinue sale of Holy Bible	false
Starbucks Just Placed Trump's Photo on Floor so Every Customer have to Step On It....	false
Trump Just Gave Every WORKING, LEGAL Man Woman And Child In The USA $612 EACH!	false
“It’s Only A Matter Of Time Before We Can Own Colored People Again” says NRA President Jim Porter	false
The CNN porn scare is how fake news spreads	false
“Nobody Can Blame You For Beating Your Wife If It’s Out Of Love”	false
BREAKING Trump’s Android Device Believed To Be Source Of Recent White House Leaks	false
Jimmy Carter ‘Medical Marijuana Cured My Cancer’	false
MAN PARDONED BY OBAMA 3 MONTHS AGO ARRESTED FOR MURDER	false
Whoopi Goldberg: Navy SEAL Widow was "Looking for Attention"	false
BREAKING Leaked picture of Obama being dragged before a judge in handcuffs for wiretapping Trump	false
FBI Issues Warrant For Obama’s Arrest After Confirming Illegal Trump Tower Wiretap – Americas Last Line of Defense	false
Home	false
Snoop Dogg Arrested For Conspiracy After Talking About His ‘Murder Trump’ Video	false
GEORGIA BECOMES FIRST STATE TO BAN MUSLIM CULTURE IN HISTORIC MOVE TO RESTORE WESTERN VALUES!!! – News 4 Everyday	false
Lady Gaga Reveals Plan To Cover Her Face Again “Until Trump Gets Fired From Office And I Feel Free Once More”	false
President Trump Just Told Paul Ryan ‘You’re Fired’ – Americas Last Line of Defense	false
NBC Just Fired Megyn Kelly Before Her New Show Begins	false
New York Man Wanted For Infecting 240 Men And Women With HIV!!!	false
South African firm ordered to lay off 3,389 white employees	false
Colorado Rockies Baseball Team To Sell Marijuana Brownies At Their Concession Stands	false
New Star Wars Movie Filming Near Rosenberg Texas Large Number of Extras Needed	false
BREAKING Ken Starr’s Plane Just Disappeared On His Way To DC To Testify Against Hillary	false
BREAKING Autopsy Results From Vince Foster’s Exhumed Body–Cause Of Death To Be Changed	false
Doctors Who Discovered Cancer Enzymes In Vaccines All Found Murdered	false
Police Find 19 White Female Bodies In Freezers With “Black Lives Matter” Carved Into Skin	false
BREAKING Florida Moves For FULL RECOUNT Of State Over Massive Voter Fraud DETAILS	false
2 Liberal Democrat Congressmen Arrested For Planning Trump’s Assassination	false
Evangelical Leader Says Those Who Oppose Trump Could Be “Punished” with Gay Child	false
“If A Woman Is Not Intelligent Enough To Keep Her Legs Closed, How Can We Entrust The Abortion Decision To Her?” – WalkWithHer	false
Vin Diesel Had This to Say About the Residents of Rockford, Illinois – WBN 12 News	false
Texas law enforcement officer fatally shot upon arriving for work by 3 muslim refugee. Do you support to deport them?	false
Tampa man loses testicles after trying to 'fill scuba tank with weed smoke'	false
United Airlines Flight Attendant Slaps Crying Baby During Flight	false
MALIA OBAMA EXPELLED FROM HARVARD	false
Trump on Revamping the Military	false
Eric Trump ‘My Father’s Tax Return Is Irrelevant Because We’re Going To Cancel Taxes For WEALTHY People Anyway’	false
ProLifers Declare Ejaculation Is Murder Every Sperm Cell Is A Life	false
I Love Native Americans	false
Trump warns Russia over Jehovah’s Witnesses ban and urges members to seek asylum in the US	false
Donald Trump to issue an executive order to ban Facebook across US	false
BREAKING NEWS Sarah Palin In A Coma After Hit And Run	false
Conservative Icon Ted Nugent Killed In Hunting Accident – Americas Last Line of Defense	false
Lindsey Graham threatens to convert to Democrat if Republicans don’t Dump Trump	false
Bill O’Reilly In Critical Condition After Being Attacked By ‘Tolerant’ Liberals – News Feed Hunter	false
BREAKING Clinton Foundation Ordered To Cease Operations – Chelsea Charged With Fraud	false
BREAKING NEWS: Road racing cyclist Lance Armstrong has died	false
Fox Star Tucker Carlson In Critical Condition After Head On Collision Driving Home – We Conservative	false
Pence: “Michelle Obama Is The Most Vulgar First Lady We’ve Ever Had”	false
FBI Uncovers Evidence That 62 Million Trump Voters are All Russian Agents!	false
JEFFERSON DAVIS STATUE TO BE REPLACED WITH OBAMA LIKENESS	false
Family's private investigator: There is evidence Seth Rich had contact with WikiLeaks prior to death - Story	false
Donald Trump Praises Colonel Sanders for His Service in the Civil War	false
NASA Will Pay You $18,000 To Stay In Bed And Smoke Weed For 70 Straight Days	false
COMEY KNEW MURDERED DNC STAFFER, SETH RICH, WAS WIKILEAKS SOURCE & COVERED IT UP FOR HILLARY	false
Obama Canceled It, Trump Reinstated It – A Very Sacred Day is Back -	false
Trump Gives Chaffetz The Thumbs Up For Investigating Hillary Clinton's Email Server	false
“Rape Victims Should Be In Custody If There Is Suspicion That They’re Planning Abortion”	false
Monica Lewinsky Found Dead In Roslindale – Freedum Junkshun	false
Sarah Palin Calls To Boycott Mall Of America Because “Santa Was Always White In The Bible”	false
Trump Removing Marines From the Navy	false
Edward Snowden: Osama Bin Laden is Still Alive Living in the Bahamas	false
Keanu Reeves Shock The World With Another Powerful Message	false
The DEA Just Raided A United States Senator–Dems In A Panic – News Feed Hunter	false
NASA Confirms Earth Will Experience 15 Days Of Darkness In November 2017	false
Democrat Maxine Waters Has Shown Up To Only 10% Of Congressional Meetings For 35 YEARS	false
Liberal Women Hate Me Because Of My "Striking Beauty And Intellect", Says Kellyanne Conway	false
Cannibals Arrested in Florida Claim Eating Human Flesh Cures Diabetes and Depression	false
Libtard Hero Al Franken Forced To Resign In Disgrace	false
Chinese Lunar Rover Finds No Evidence Of American Moon Landings!	false
Proof The Mainstream Media Is Manipulating The Election By Taking Bill Clinton Out Of Context	false
Charity: Clinton Foundation Distributed “Watered-Down” AIDS Drugs to Sub-Saharan Africa – Eagle Rising	false
A Hillary Clinton Administration May be Entirely Run by a FIGUREHEAD – Eagle Rising	false
Trump’s Latest Campaign Promise May Be His Most Horrible One Yet	false
Website is Down For Maintenance	false
Obama Pushes One World Government	false
Clinton Foundation Spent 5.7% on Charity; Rest Went to “Salaries” and “Other Expenses” – Eagle Rising	false
WHOA! NEW DISTURBING VIDEO Shows HILLARY'S Campaign Likely FAKED Her Audience At NC Rally * 100percentfedUp.com	false
Is it the Beginning of the End for Hillary Clinton? – Eagle Rising	false
Californians Had Special Way to View the Eclipse… Now Hospitals Are Filling up	false
Obama Just DISGRACED The U.S. By Surrendering To ISIS In Front Of Entire U.N. ⋆ US Herald	false
Declassified Docs Show That Obama Admin Created ISIS In 2012 To Use As A 'Tool' ⋆ US Herald	false
A Hillary Clinton Administration May be Entirely Run by a FIGUREHEAD – Eagle Rising	false
BREAKING: Did Hillary Clinton Have a Nervous Breakdown?	false
Hillary Denies She and Obama Founded ISIS…Then This Video Shows Up	false
Trump Just Made A Campaign Promise So Ridiculous It Makes ‘Read My Lips’ Look Good ‹ Opposition Report	false
Top Army Chief of Staff General Has Had It With Obama Incompetence ⋆ US Herald	false
Congress MUST Act! Five Days Until Obama's Internet Giveaway [Video]	false
Clemson BANS Memes Featuring Dead Gorilla Harambe…Promotes “Rape Culture” and “Racism” – Eagle Rising	false
How Democrats are Going to Try to STEAL the Election for Hillary – Eagle Rising	false
“If You Can’t Run Your Own House, You Certainly Can’t Run the White House” – Eagle Rising	false
CNN’s Post-Debate Rigged Poll Busted…Here Are The Real Results	false
Why is it “RACIST” to Question Someone’s Birth Certificate? – Eagle Rising	false
Homosexual Thinks Muslims Will Accept Him, Instantly Learns How They Deal With LGBT	false
REVEALED! Minnesota Mall Attacker ID'd As One Of Hillary's Somali Muslim Refugees	false
NYC Terrorist Ahmad Rahami Sued Police Department for ‘Religious Persecution’ in 2011! ⋆ Freedom Daily	false
Fast Food CEO Threatens To Fire Everyone If A Democrat Wins The Presidency	false
BREAKING: WikiLeaks Releases Proof Hillary Lied and The FBI Covered It Up	false
Angela Merkel Admits Bringing In Muslim Refugees Was A Big Fat Mistake	false
DISGUSTING! Because Of Hillary & Obama, NY Terrorist Will Get Better Treatment Than US Vets! ⋆ Freedom Daily	false
DESPICABLE! Hillary Wants To Put Hero Cop Who Stopped Mall Terror Attack Out Of BUSINESS ⋆ Freedom Daily	false
UNFIT! Look What Hillary Needed To Get Up The Stairs At Her Rally Today! ⋆ Freedom Daily	false
Website is Down For Maintenance	false
HILLARY ON DISABLED CHILDREN During Easter Egg Hunt: "When are they going to get those f*g ree-tards out of here?" * 100percentfedUp.com	false
No WAY! Liberal Judge Just Made A Law For Black Males To Do This DISGUSTING Thing To Cops ⋆ Freedom Daily	false
Clinton's Exploited Haiti Earthquake ‘to Steal Billions of Dollars from the Sick and Starving’ ⋆ Freedom Daily	false
BOOM! Merkel Admits Flooding Germany With Muslim Refugees	false
SICK! Muslim Refugee Beats, Urinates On Pregnant Woman After Seeing What She Has ⋆ Freedom Daily	false
Republicans Push Bill To Legalize Voter Intimidation To Help Trump In Pennsylvania	false
Female Muslim-American Olympian Bashes U.S.A. —Goes Off The Hinges About Why America Sucks! ⋆ Freedom Daily	false
Charlotte Thugs Leaves Cop’s Body With Disgusting Thing They Did... ⋆ Freedom Daily	false
Obama Told Americans That Their Freedom Is Over And	false
Tebow DISMANTLES national anthem protests in one sentence...BOOM! ⋆ Freedom Daily	false
Federal Agents Make Massive Discovery at Southern Border… ISIS Is Here ⋆ Freedom Daily	false
'Reporters' FLEE When Clintons Get EXPOSED!	false
Australia Voted To Ban Muslims And Liberals Are Pissed	false
Two White Men Doused With Gasoline, Set On FIRE By Blacks	false
ALERT: Police Pull Over ‘Islamic Refugee,’ Horrified To See What Was In The Car	false
CNN’s Post-Debate Rigged Poll Busted…Here Are The Real Results	false
The NFL Told Russell Wilson Not To Speak About His Faith, So He Did Something Fans Couldn't Believe ⋆ Freedom Daily	false
The Pope Flat Out Called Fox News Type Journalism ‘Terrorism’	false
HERE IT IS! The Winner of the First Debate Was Just Announced, And the Winner Is…	false
Hillary Thought She Won The Debate. Didn’t Expect This To Happen To Prove Her Wrong.	false
Riot Police DID Shoot Unarmed Charlotte Protester In Head	false
ABC Reveals Trump Paid "Hundreds Of Millions" By Russian Oligarchs	false
Bombing Suspect Filed Anti-Muslim Discrimination Lawsuit Against Police – Eagle Rising	false
New Jersey Moves To Impeach Chris Christie Over "Bridgegate"	false
Newsweek Accuses Trump Of Committing A Felony	false
Surgeon General warns: Drinking every time Trump lies during debate could result in acute alcohol poisoning	false
Putin's Troll Army Caught Rigging Twitter To Pretend Trump Won	false
Trump Supreme Court Pick Sued By Feds For Racial Discrimination	false
Note In Arabic Found With NYC Bomb… Call Says There Will Be More Bombings	false
Donald Trump Goes Off The Deep End–May Be Unfit For Debate ‹ Opposition Report	false
Secret Video Records MASSIVE Hillary Event Flop!	false
CNN FURIOUS and Embarrassed After Trump Called Them Out For One Major Thing	false
New York bomb Suspect SUED Police!	false
Clinton Foundation Spent 5.7% on Charity; Rest Went to “Salaries” and “Other Expenses” – Eagle Rising	false
Obama’s Speech In New York Shocks Americans When He Says THIS About Attacks!	false
Bill And Hillary Clinton Have A MAJOR AIDS Scandal!	false
Changing Your Baby's Diaper Is Now A Sex Crime In Arizona	false
Michelle Obama NOT Leaving The White House – Hillary Clinton Has Terrifying New Role For Her!?!?	false
New Clinton Foundation SCANDAL Just Broke – This Is What Hillary ACTUALLY Thinks About Black People…	false
BREAKING: Judge DEMANDS Release Of Clinton’s Security Training Files – She Has 5 Days…	false
Networks Confirm They Will Not Be Fact-Checking Donald Trump In Any Way	false
Decades-Old Clinton Friend Comes Forward, Says She Knows What's Happening to Hillary	false
‘We Don’t Adapt To Your Culture, You Adapt To Ours’	false
White Guy Walled In Car By BlackLivesMatter Protesters – They See What He’s Brandishing And Scatter…	false
The Black Sphere with Kevin Jackson	false
Obama: “I bet when I die you’ll be happy to pee on my grave.”	false
SURPRISE! 70% Of Charlotte RIOTERS Are Not From There – Guess What That Means… [VIDEO]	false
Hillary's DEAD!?!? Brand New Theory Has Serious PROOF	false
EXPOSED: Soros Funding Fake Veterans’ PAC To Take Trump Down	false
OUTRAGE! Obama Spends $770M Dollars In Tax Payer Money To Renovate Mosques Over Seas… [VIDEO]	false
BOOM! Marines Send TERRORISTS Scathing Message [VIDEO]	false
BOOM! Charlotte Officials FINALLY Silence Rioters With One E P I C Announcement! [VIDEO]	false
BREAKING: Steps to FORCE FBI Director Comey to Resign In Process – Hearing Decides His Fate Sept 28	false
Hillary’s TOP Donor Country Just Auctioned Off ISIS Sex Slaves…	false
Cavuto Just Exposed Lester Holt's Lies During Debate	false
The AP, In 2004, Said Your Boy Obama Was BORN In This Particular Country	false
People Noticed Something Odd About Hillary's Outfit	false
People Noticed Something Odd About Hillary’s Outfit at the Debate Last Night	false
Another Terrorist Attack in NYC…Why Are we STILL Being Politically Correct – Eagle Rising	true
Donald Trump: Drugs a 'Very, Very Big Factor' in Charlotte Protests	true
Obama To UN: ‘Giving Up Liberty, Enhances Security In America…’ [VIDEO]	true
Trump vs. Clinton: A Fundamental Clash over How the Economy Works	true
President Obama Vetoes 9/11 Victims Bill, Setting Up Showdown With Congress	true
CHAOS! NC Protest MOB Ambushes Female Truck Driver, Loots Truck, Sets Cargo On Fire – No One Helps!? [VIDEO]	true
10 Moments That Mattered From Hillary Clinton and Donald Trump's First Debate	true
Young Girl's Emotional Council Speech Laments 'Shame' of Fatal Charlotte Shooting	true
Jeb Bush to lecture at Harvard this fall	true
Clinton vs. Trump: The debate before the debate	true
Is Hillary in a No-Win Situation?	true
Hillary Clinton on police shootings: 'too many people have lost their lives who shouldn't have'	true
Johnson: 'I’m going to sleep well at the end of all this'	true
Anthony Weiner Under Federal Investigation for Alleged Sexting With a Minor	true
Senate Dems Move To Force Trump To Release His Tax Returns	true
Dem congressman to IRS: Audit the Trump Foundation	true
Armed Intruders Break in House…Armed Resident Responds – Eagle Rising	true
Post-debate, Trump team hits moderator Holt for 'some hostile questions'	true
One Critically Wounded As Charlotte Police Endure Second Night Of RIOTS… [VIDEO]	true
Rouhani: Iran deal able to weather the election	true
“How Can we LEAD When we Can’t Even Control Our Own Cities?” [VIDEO] – Eagle Rising	true
9 times Ted Cruz insulted Donald Trump before endorsing him	true
Critical counties: Wake County, NC, could put up a fight	true
Obama wears hat, breaking ‘Politics 101’ rule on headgear	true
Clinton: ‘The next 50 days will determine the next 50 years’	true
I Was RFK’s Speechwriter. Now I’m Voting for Trump. Here’s Why.	true
NC State Troopers Take A Knee Before Protecting Charlotte – But It Wasn’t To Protest The National Anthem…	true
Sacramento mayor punches pie thrower	true
Megan Rapinoe Punished Over Not Standing For Anthem?	true
Liberals Are Furious When Reality Star Brody Jenner Tells the Truth About Police Shootings on Twitter	true
Donna Brazile slams Trump for not apologizing for birther claims	true
US builds working theory on cause of Syrian airstrike	true
Emmy Host Kimmel Calls Out Dude Who Made Trump A Reality TV Star For Helping Destroy America (VIDEO)	true
NFL Superstar Unleashes 4 Word Bombshell on Reporter Pushing Him to Protest Anthem	true
Trump-Clinton debates will stream on Twitter	true
Joe Biden Slams Donald Trump's Comment That Housing Crisis Was 'Good Business'	true
National poll: Clinton leads Trump by 6	true
“Public School Forced My Child To	true
ABC News – Breaking News, Latest News, Headlines & Videos	true
How to watch the first presidential debate	true
Topics for first presidential debate announced	true
KISS Bassist Gene Simmons on How to Stop Islamic Terrorism	true
Clinton: Tulsa shooting 'unbearable,' should be 'intolerable'	true
Conway: Trump will explain his Islamic State plan if asked	true
Obama in NYC: 'We all have a role to play' in terror fight after suspected bombings	true
Obama: Refugee crisis is test of our humanity	true
Trump labels Clinton 'weak and ineffective' in wake of bombings	true
In Defense of ‘He Said/She Said’ Journalism	true
Inmate Dead From Alleged Mistreatment In Jail Run By Infamous Pro-Trump Sheriff	true
Debate Commission STUNS Journalists By Siding With Trump: Fact Checking Is Out Of Bounds (VIDEO)	true
Trump camp: ‘Donald Trump is guilty of answering the question asked’	true
France becomes the first country to ban plastic plates and cutlery	true
Paul Ryan ducks on stop-and-frisk	true
Charlotte Police REVEAL What They Said To Black Man Just Moments Before Shooting…	true
Kaine visits site of Orlando mass shooting	true
Obama weighs in on the debate	true
How Trump Is Hiding From The Media Like A Total Coward	true
“Why Aren’t I 50 Points Ahead?” – Eagle Rising	true
Bobby Knight: Nobody can 'correct mistakes' like Trump	true
BREAKING: Pipe Bombs Found in New Jersey Train Station	true
Hillary Clinton on Between Two Ferns: 'I really regret doing this'	true
Magistrate won't order federal arraignment for bombing suspect	true
US: ISIS did not use mustard agent in base attack	true
Terrorist Attacks Will Likely Affect 2016 Presidential Race, Experts Say	true
Everything you need to know about Trump and Clinton’s first 2016 presidential debate	true
U.S. attorney sees no rush to arraign Rahami in federal court	true
Donald Trump's rise puts Ted Cruz in a bind	true
Trump hits Clinton on Islamic State: ‘It is time for change’	true
Bridgegate: Port Authority officials planned to make Fort Lee 'traffic jam as bad as possible'	true
Bono: ‘Trump is potentially the worst idea that ever happened to America’	true
2016 presidential race tightens in Florida	true
HuffPo Just Dropped The Mic On Internet Polls Saying Trump Crushed Hillary In Last Night’s Debate	true
Tim Kaine on Libertarian ticket: 'Everybody knows they're not going to win'	true
Watch Joe Biden Take Trump’s Own Words And Tear Him To SHREDS After Debate (VIDEO)	true
U.S. mistakenly granted citizenship to hundreds of immigrants	true
Insiders: The heat is on Hillary	true
Donald Trump Jr. Just Pinned A Tweet So Stupid It Will Make Your Eyes Bleed ‹ Opposition Report	true
More Milestone Moments for Donald Trump! – Eagle Rising	true
Donald Trump retreats to friendly media ground	true
Pence gives no specifics on why Trump Foundation story is inaccurate	true
Details Emerge About NYC Bomb Suspect Ahmad Khan Rahami	true
Trump’s puzzling pitch to black voters	true
Joe Arpaio: Trump didn’t call Obama’s birth certificate ‘legitimate’	true
Barack Obama at Benjamin Netanyahu meeting: 'He is always very candid with us'	true
McAuliffe hangs with Willie Nelson -- and his weed	true
The Mystery of Trump’s Man in Moscow: Carter Page	true
It’s “Trump is HITLER” Month at the Washington Post – Eagle Rising	true
Obama’s team isn’t laughing at Trump anymore	true
Georgia poll: Donald Trump, Hillary Clinton in tight race	true
Chelsea Handler Gets The Last Word After RNC Chair Attacks Hillary For Not Smiling (VIDEO)	true
Is Donald Trump qualified to be president?	true
